NO textures/north.png
F 57,171,86

EA textures/east.png
EA textures/east.png

C 1,2,1
SO textures/south.png




        1111111111111111111111111
        1000000000110000000000001
        1011000001110000000000001
        1001000000000000000000001
111111111011000001110000000000001
100000000011000001110111111111111
11110111111111011100000000001
11110111111111011101010010001
11000000110101011100000010001
10000000000000001100000010001
100000000S000001101010010001
110000011101010111110111100111
1110111 1110101 101111010001
11111111 1111111 111111111111