NO textures/n.png
SO
EA textures/e.png
WE textures/w.png

F ,,
C 139,224,244

        1111111111111111111111111
        1000000000110000000000001
        1011000001110000000000001
        1001000000000000000000001
111111111011000001110000000000001
100000000011000001110111111111111
11110111111111011100000000001
11110111111111011101010010001
11000000110101011100000010001
10000000000000001100000010001
100000000W000001101010010001
110000011101010111110111100111
1110111 1110101 101111010001
11111111 1111111 111111111111