SO textures/s.png
NO textures/n.png
EA textures/e.png
WE textures/w.png

F 57,171,86
C 139,224,244

1111    111111111111
1001    100000000001
1111    1000N0000001
        100000000001
        111111111111