SO textures/south.png
NO textures/north.png
EA textures/east.png
WE textures/west.png

F 5,4,3
C 5,5,4

1111    111111111111
1001    100000000001
1111    1000W0000001
        100000000001
        111111111111